



########################################
#################   ooo  G   ######### #
#K#### #######    o#  ###### #########o#
#        ooo   #  o#  ###### #########o#
###### #### ####  o#  ###### #########o#
#oo  # #### ####  o#   ooo ooo  G   ##o#
#### # #### ###### ################### #
#H   ooo     # ###      ooo D######### #
########### ## ### ###################D#
 P    o    C       ##O
########################################